
C 0,0,0
F 220,0,100

NO ./xpm/file1.xpm
SO ./xpm/file2.xpm
WE ./xpm/file3.xpm
EA ./xpm/file4.xpm

1111111111111111111111111111111111111111111
1100000010000000000000000000000000000000001
1000000010000001000000111111111100000000001
1000100010000001000000000011000000000000001
1000000010000000000000000000100010000000001
1000000000000N00011000000000000010000000001
1000100000000000000000000000000010000000001
1000100000000000000000000000000010001110001
1000000011111110000000000000000000000010001
1000000000000000011100000100000000000011101
1000000000000000000000000100000000000000001
1000000000000000000000000100000001110000001
1000000001111111111111110000000010000000001
1000000000000000000000000000000000000000001
1111111111111111111111111111111111111111111
