
C 224,255,255
F 128,122,116

NO ./image/wallnb1.xpm
SO ./image/wall.xpm
WE ./image/wallnumber1.xpm
EA ./image/wall3.xpm

1111111111111111111111111111111111111111111
1100000010000000000000000000000000000000001
1000000010000001000000111111111100000000001
1000100010000001000000000011000100000000001
1000000010000000000000000000100010000000001
1000000000000000011000000000000010000000001

ss
1000100N00000000000000000000000100000000011
1000000000000001000000000000000010001110001
1000000011111110000000000000000000000010001
1000000000000000011100000100000000000011101
1000000000000000000000000100000000000000001
1000000000000000000000000100000001110000001
1000000001111111111111110000000010000000001
1000000000000000000000000000000000000000001
1111111111111111111111111111111111111111111
