
C 255,30,56
F 220,100,100

NO ./xpm/file1.xpm
SO ./xpm/file2.xpm
WE ./xpm/file3.xpm
EA ./xpm/file4.xpm

        111111111111111111111
        1000000000110000000001111
        1011000001110000000000001
        1001000000000000000000001
111111111011000001110000000000001
100000000011000001110111111111111
11110111111111011100000010001
11110111111111011101010010001
11000000110101011100000010001
10000000000000001100000010001
100000N00000000011010100100011111111
11000001110101011111011110001
11110111 1110101 101111010001
11111111 1111111 111111111111