
C 255,30,56
F 220,100,100

NO ./xpm/file1.xpm
SO ./xpm/file2.xpm
WE ./xpm/file3.xpm
EA ./xpm/file4.xpm

        11111111111111111111111
        1000001000100000000001111
        1010000001110000000000001
        1001000000000000000000001
111111111011000001110000000000001
111000000011000001110111111111111
   11110111111111011100000010001
   11110111111111000001010010001
1111000011010101010000001000111
10000000000000001000000010001
10000000000000010101010010011111111
1000N000000000000000000000001
11000001110101011111011110001
11110111 1110101 101111010001
11111111 1111111 111111111111