NO ./xpm/file1.xpm
SO ./xpm/file2.xpm
EA ./xpm/file3.xpm
WE ./xpm/file4.xpm

C 111,18,49
F 54,54,34

111111111111111
100000100000001
10000111111111111111111111
10000011000001000000010001
10000010000000000000000001
10000011000N00000000010001
11101111111011111111110001
1100001100000001      10001
100000010000001      10001
1000000010000001      10001
10000000000000111111111011111111111
10000001000000100000000000000000001
100000010000001000000000000000000011111
110000110000001001110000000000110010001
1111111111111111001000000000000010010001
              1000000000000000000010001
              1000000000000000000010001
              1000000000000000000000001
              1000000000000000000010001
              1000000000000000000010001
              1001000000000000010010001
              1001100000000000110010001
              1000000000000000000010001
              1000000000000000000010001
              1111111111111111111110001
                                  10001
                               11110001111
                                10000000001
   1111111111111               10000000001
   100000000001               10000000001
   1000000000001               10000000001
   1000000000001               10000000001
   1000000000001               10100000101
   1000000000001               10000000001
   10011111111111111111111     11111011111
   10000000000000000000001       100001
   11110000000000000000001       100001
      10000000000000000001       100001
  1111100000000000011101111111111100001
  1000000000000000010000000000000000001
  1000100000000000010000000000000000001
  1000100000000000010000000000000000001
  1000111111011111110000000000000000001
  1000000010001    11101111111111111111
  1000000000001    100000000001
  1000000010001    100000000001
  1111011110001    100000000001
    10001 10101    100000000001
    10001110111    100000000001
    10000000001    100000000001
    11111100001    111111011111
         110001        10001
          10001        10001
           10001       10101
            10001      11111
             10001
              10001
               10001
                10001111111111111111111111111111111111111
                10000010001000001000000010000000001010001
                11101010101011101011101110111011101011101
                10001000101010101000100000101010000000001
                10101110111110101111111010101110111111111
                10101000101000001000001000101000001000001
                11101110101111111010111110101010111011111
                10001000000010000010100010000010100000001
                10111111111011101010101111111110111111101
                10100000001000001010000010000010001010001
                11101010111110111011111010111111101010101
                10001010100000100000001010100000100010101
                10101110101011101111101100101110111010111
                10101000101010000010000010001000000010001
                10101011101010111011111111111010111010101
                10101000001010101000000000001010001000101
                1010111111101010101110111110101110111110111111111
                1010000010001000101000000010101000000010000000001
                1111111111111111111111111111111111111111100000001
                                                        100000001
                                                        100000001
                                                        100000001
                                                        100000001
                                                        111111111
